###########################################################################################################
#                                                                                                         #
#                                                                                                         #
#                                                                                                         #
#                                                                                                         #
#                                                                                                         #
#                                                                                                         #
#                                                                                                         #
#                                                                                                         #
#                                                                                                         #
#                                                                                                         #
#                                                                                                         #
#                                                                                                         #
#                                                                                                         #
#                                                                                                         #
#                                                                                                         #
#                                                                                                         #
#                                                                                                         #
#                                                                                                         #
#                                                                                                         #
#                                                                                                         #
#                                                                                                         #
#                                                                                                         #
#                                                O                                                        #
#                                                X                                                        #
#                                                P                                                        #
#                                                                                                         #
#                                                                                                         #
#                                                                                                         #
#                                                                                                         #
#                                                                                                         #
#                                                                                                         #
#                                                                                                         #
#                                                                                                         #
#                                                                                                         #
#                                                                                                         #
#                                                                                                         #
#                                                                                                         #
#                                                                                                         #
#                                                                                                         #
#                                                                                                         #
#                                                                                                         #
#                                                                                                         #
#                                                                                                         #
#                                                                                                         #
#                                                                                                         #
#                                                                                                         #
#                                                                                                         #
#                                                                                                         #
###########################################################################################################