############
#         O#
#   P   ####
#          #
######     #
#   O##    #
#    ##    #
#          #
#      XX  #
#      #   #
############
