#################################
#                            X  #
#     O                         #
#     X                     XX  #
#                               #
#                               #
#              P               X#
#                               #
#                               #
#                               #
#                         O     #
#                               #
#                               #
#################################
